###############
#0000000000000#
#0000000000000#
#00##00#00##00#
#00##00000##00#
#0000000000000#
#0000000000000#
#00#000!000#00#
#0000000000000#
#0000000000000#
#00##00000##00#
#00##00#00##00#
#0000000000000#
#00000@0000000#
###############