##0####
#00000#
#0#000#
#00@00#
#000!0#
#00000#
#######