#######
#00000#
#0#000#
#00@00#
#00000#
#00000#
#######