##!####
#00000#
#0#000#
#00@0!#
#00000#
#00000#
#######